#nodes (naive_nbr),core number (naive_nbr),#nodes (graph_core),core number (graph_core),#common nodes,cumulative sum
285,279,285,279,285,285
253,252,253,252,253,538
136,135,136,135,136,674
114,113,114,113,114,788
224,111,224,111,224,1012
102,101,102,101,102,1114
95,94,95,94,95,1209
90,93,90,93,90,1299
91,90,91,90,91,1390
89,89,89,89,89,1479
